Ardèche=Privas
Nièvre=Nevers
Vienne=Poitiers
Creuse=Guéret
Finistère=Quimper
Calvados=Caen
Gers=Auch
Drôme=Valence
Côtes-d'Armor=Saint-Brieuc
Maine-et-Loire=Angers
La Réunion=Saint-Denis
Lot-et-Garonne=Agen
Charente=Angoulême
Aude=Carcassonne
Sarthe=Le Mans
Aveyron=Rodez
Deux-Sèvres=Niort
Eure-et-Loir=Chartres
Pas-de-Calais=Arras
Haut-Rhin=Colmar
Corse-du-Sud=Ajaccio
Cantal=Aurillac
Pyrénées-Atlantiques=Pau
Hautes-Alpes=Gap
Ardennes=Charleville-Mézières
Haute-Corse=Bastia
Allier=Moulins
Charente-Maritime=La Rochelle
Eure=Évreux
Haute-Loire=Le Puy-en-Velay
Saône-et-Loire=Mâcon
Martinique=Fort-de-France
Aube=Troyes
Hautes-Pyrénées=Tarbes
Savoie=Chambéry
Haute-Garonne=Toulouse
Seine-Saint-Denis=Bobigny
Vendée=La Roche-sur-Yon
Haute-Marne=Chaumont
Marne=Châlons-en-Champagne
Bas-Rhin=Strasbourg
Seine-Maritime=Rouen
Gironde=Bordeaux
Aisne=Laon
Ille-et-Vilaine=Rennes
Loir-et-Cher=Blois
Alpes-de-Haute-Provence=Digne-les-Bains
Indre-et-Loire=Tours
Loire=Saint-Étienne
Meurthe-et-Moselle=Nancy
Tarn-et-Garonne=Montauban
Val-d'Oise=Cergy
Haute-Savoie=Annecy
Pyrénées-Orientales=Perpignan
Morbihan=Vannes
Moselle=Metz
Vosges=Épinal
Mayotte=Mamoudzou 
Mayenne=Laval
Somme=Amiens
Tarn=Albi
Hérault=Montpellier
Côte-d'Or=Dijon
Loire-Atlantique=Nantes
Guyane=Cayenne
Cher=Bourges
Ain=Bourg-en-Bresse
Val-de-Marne=Créteil
Yonne=Auxerre
Lot=Cahors
Yvelines=Versailles
Ariège=Foix
Jura=Lons-le-Saunier
Indre=Châteauroux
Meuse=Bar-le-Duc
Guadeloupe=Basse-Terre
Territoire de Belfort=Belfort
Seine-et-Marne=Melun
Manche=Saint-Lô
Loiret=Orléans
Bouches-du-Rhône=Marseille
Hauts-de-Seine=Nanterre
Corrèze=Tulle
Var=Toulon
Orne=Alençon
Puy-de-Dôme=Clermont-Ferrand
Dordogne=Périgueux
Nord=Lille
Haute-Saône=Vesoul
Gard=Nîmes
Haute-Vienne=Limoges
Lozère=Mende
Landes=Mont-de-Marsan
Alpes-Maritimes=Nice
Oise=Beauvais
Isère=Grenoble
Vaucluse=Avignon
Essonne=Évry
Paris=Paris
Doubs=Besançon
Lyon=Lyon
